!!!!!!!!!!!!!!!!!!!!!!!!!!!!!!!!!!!!!!!!!!!!!!!!!!!!!!!!!!!!!!!!!!!!!!!!!!!!!!!!
!                                                                              !
!   ###########################################################      ,    ^    !
!   #                       #█████████#                       #     ,,         !
!   # #############         ###########        ############## #    ,,    ,     !
!   # #                                                     # #    ,     ,,,   !
!   # #                                                     # #          ,,,   !
!   # #                      ##▒▒▒▒▒##                      # #      ^   ,,    !
!   # #                      ▒       ▒                      # #        ,,,     !
!   # #                      ▒   ▢   ▒                      # #      ,,,,,     !
!   # #                      ▒       ▒                      # #      ,,,,      !
!   #                        ▒       ▒                        #      ,,,       !
!   ###########              ▒▒▒▒▒▒▒▒▒             ############       ,   ^    !
!  ^          #                                    #                           !
!      ,,     #                                    #                           !
!   ,,,,,     ################## . #################            ,,,,           !
!  ,,,,                         ...                          ,,,, ,,,          !
!   ,,                    ^     ..    ^                    ,,,,,,,, ,    ^     !
!   ,, ^                        ....                      ,, ,,,^,, ,          !
!   ,         ^                  ...                      ,,,,,,,,,,           !
!   ,                            ......                       ,,,,             !
!                                  .................        A                  !
!     ^                               ...............       @              ^   !
!!!!!!!!!!!!!!!!!!!!!!!!!!!!!!!!!!!!!!!!!!!!!!!!!!!!!!!!!!!!!!!!!!!!!!!!!!!!!!!!