!!!!!!!!!!!!!!!!!!!!!!!!!!!!!!!!!!!!!!!!!!!!!!!!!!!!!!!!!!!!!!!!!!!!!!!!!!!!!!!!
!                                   ##########                                 !
!   #################               #        ##########    ,,,    ##########   !
!   #       ○       #               # ■              ○#   ,, ,    #        #   !
!   #       #       #################              #  #   ,,,     #     ○  #   !
!   ###                                            #  #          ##        #   !
!     #     ■                                      #  #                    #   !
!   ###             #################              #  #                 ■  #   !
!   #             # #               # ■            ####          ##        #   !
!   #               #    ,,,,,,,    #                ○#           ##########   !
!   #             # #  ,,, ,,,,,    ###################                        !
!   #               #  ,,,,, ,,                                    #########   !
!   #  ■          # #    ,,,,,     ,     ,,,,,,,,,,, ,,,,          #.......#   !
!   ####            #               , , , ,,,,,,        ,          #...▣...#   !
!      #          # #                      ,,,, , , ,,             #.......#   !
!   ####            #                                              ##▒▒▒▒▒##   !
!   #          #  # #                                                          !
!   #○              #                                                          !
!   ###########   ###            ### ### ###                                   !
!             #   #              # # # # # #                                   !
!     ,,,                        ### ### ###                                   !
!  ,,,        #                                                        @       !
! ,,  ,,,        #                 #                                           !
!!!!!!!!!!!!!!!!!!!!!!!!!!!!!!!!!!!!!!!!!!!!!!!!!!!!!!!!!!!!!!!!!!!!!!!!!!!!!!!!