!!!!!!!!!!!!!!!!!!!!!!!!!!!!!!!!!!!!!!!!!!!!!!!!!!!!!!!!!!!!!!!!!!!!!!!!!!!!!!!!
!                                                                         ▒▒▒▒▒!
!            ,  , ,                ^^   ^                   ,,            #   #!
!     ,, ,,,, ,,,           ^     ,, ,,,,,    ○   ,,,,     ^  ,,,   ,^,,, # ◴ #!
!  , ,,,, ,,,■,  ,, ^              ,,                  ,,, ,  ,,       ,  #   #!
! ,    ^,,     ,, ,              ^     ,,,    ,      ^,  ,   ,,,    ,     ▒▒▒▒▒!
! ,,  , ,,,,,,,, ,      ^                      ,      , ,,,   ,,,              !
!   ,, ,,   ,,,  ,          ,   ,,,,   ^        ^      , ,  ,  ^        ○   ^  !
!      , ,,,,  ,,  ^        ,   ,,,^,,         ,,                ^  ,,   ,,    !
!        ,  ,,,                ,^,  ,   , ,,,   ,,   ^          ,,,,      ,,   !
!    ^    ,           ^       ,,,,,,   ,^  ,,  ^,         ,,  ,                !
!             ,    ,    ,,      ,,,  , ,   ,,,          ,  ^    ,,        ^    !
!            ,,  ,,,  ,,          , ,^    ,,,,                 , ,,       ,    !
!    ^      ,   , , ^           ,    ,, ^, ,           ^           ^    ,,,    !
!         ,, ^,, ,   ,, ^       , , ,                 ^  ,  ,     ,            !
!            , ,      ,,               ,^     ^  , ,,,,        ^   ,           !
!     ,      ,  ,,   ,,                         ,,,         ■       ,,   ^     !
!     ,, ^  ,, ,  , ,             ^           ,,,                  ,,,         !
!      , ^ , ,,,,,,^,                 ○                  , ,,    ,    ,        !
!     ^       ,,,,               ^  ,, ,,,,            ,     , ,   , , ,,      !
!     ,,,  ,, ,^            , ,     ,,   ,,,  @     , ^  ,, ,,,,,,  ,  ,, ^    !
!            ,,     ^      ,,  ^  ,,,,  , ,        ,  , ,, ,,,                 !
!        ■      ^           ,, ,, ,,,  ^,    ^,,, ,,,  ,  ,           ^        !
!                                                     , ,                      !
!!!!!!!!!!!!!!!!!!!!!!!!!!!!!!!!!!!!!!!!!!!!!!!!!!!!!!!!!!!!!!!!!!!!!!!!!!!!!!!!