!!!!!!!!!!!!!!!!!!!!!!!!!!!!!!!!!!!!!!!!!!!!!!!!!!!!!!!!!!!!!!!!!!!!!!!!!!!!!!!!
!                                                                              !
!  ########                                     |  |  |  |  |    |  |  |  |    !
!  #○     #                         ,,,         ░  ░  ░  ░  ░    ░  ░  ░  ░    !
!  #      ####################     , ,,,,,,     ░  ░  ░  ░  ░    ░  ░  ░  ░    !
!  #      #○          ○#     #     , ,,,,, ,                                   !
!  # #  # #   ##       ▒  ⟡  #      ,,   ,,,    |  |  |  |  |    |  |  |  |  ^ !
!  #          ##       ▒     #       ,,,, ,,    ░  ░  ░  ░  ░    ░  ░  ░  ░    !
!  #                   #     #      ,,,         ░  ░  ░  ░  ░    ░  ░  ░  ░    !
!  #           #####   #######                                                 !
!  #           #                                                         ^     !
!  #         ■■#                    ,,,, ,,,,,,,     ,,, ,            C        !
!  #                  ,,,, ,,,,,, ,,,,,,,, ,, ,,, ,,,,    ,,■                  !
!  #           #                                                               !
!  #############                                |  |  |  |    |  |  |  |  |    !
!                                    ,          ░  ░  ░  ░    ░  ░  ░  ░  ░    !
!                                     ,     ^   ░  ░  ░  ░    ░  ░  ░  ░  ░    !
!                 ,                ,                                         ^ !
!     ^      , ,,,,                             |  |  |  |    |  |  |  |  |    !
!       ,,,,,,,,,,,           ,          ,      ░  ░  ░  ░    ░  ░  ░  ░  ░    !
!      ,, ,,,,,,,,,         ,      ,            ░  ░  ░  ░    ░  ░  ░  ░  ░    !
!      ,,,,,,,,,,,          ,,            @                                    !
!  ^      , ,^ ,,                    ,                                         !
!!!!!!!!!!!!!!!!!!!!!!!!!!!!!!!!!!!!!!!!!!!!!!!!!!!!!!!!!!!!!!!!!!!!!!!!!!!!!!!!