!!!!!!!!!!!!!!!!!!!!!!!!!!!!!!!!!!!!!!!!!!!!!!!!!!!!!!!!!!!!!!!!!!!!!!!!!!!!!!!!
!     ,              ^                                      ^                ^ !
!     ,^ ,,    ,,,               ,,,  ^     ,,, ,       ,,,,,,  ,,     ,       !
!   ,             ,,      ,,,,        ,     , ,,  ^               ^       ^,,  !
!   ,     #####################      ^             ####################    ,   !
!   ^     #                   #  ^            ^    ##                 #    ^   !
!  ,      #####■##### ###  ## #######################    ##########   #   ,    !
!    ,  ^ #                #                             #            #    ,   !
!  , ,,   # ## ### ### ### # #      ##########           ###########  #    , ^ !
! ^,, ,   #  #               #       ▒      ▒            #    T       #  ^  ,, !
!    ,    # ## ##### ## ####         ▒   ▤  ▒            #            #    ,   !
!    ,,   #                   ####   ########   #####   ○###########  #   ,,,  !
!     ^   # ### ##  ##  ####  #                    ##                 #        !
!   ,,,   #####################                    ####################        !
!                                                                 ^      ,,^   !
!                  ^                       ,                ^            ,,    !
!                 ,,,,,,                ,,                                     !
!              ,,,, ,  ,,,                                       ,,,,    ^     !
!             ,^,,,,,,,, ,                      #           ,^ ,,              !
!              ,,,,,,,, ,           #                              ^, ,     ^^ !
!               ,,,,^        ,                            ^     ,, ,,,,^       !
!                              ,,       @    ^               ,,^,              !
!                                ,               ^                             !
!!!!!!!!!!!!!!!!!!!!!!!!!!!!!!!!!!!!!!!!!!!!!!!!!!!!!!!!!!!!!!!!!!!!!!!!!!!!!!!!