        ▒▒▒▒▒▒▒▒▒▒▒   ▒▒▒▒▒▒▒▒▒                                                 
   ▒▒▒▒▒▒▒▒▒▒▒▒▒▒▒▒▒▒ ▒▒▒▒▒▒▒▒▒▒▒▒▒▒▒▒  ▒▒▒                                     
 ▒▒▒▒▒▒▓▓▒▒▒▒▒▒▒▒▒▒▒▒▒ ▒▒▒▒▒▒▒▒▒▒▒▓▓▓▓▓▓▓▓▓▓▓▓  ▒  ▒▒▒         ▓    ▓    ▓      
▒▒▒▒▒▒▒▓▓▒▒▒▓▓▒▒▒▒▒▒▒ ▒▒▒▒▒▒▒▒▒▒▒▓▓▓▓▓▓▓▓▓▓▓▓▓▓▒▒ ▒▒▒ ▒▒      ▓▓▓  ▓▓▓  ▓▓▓     
▒▒▒▒▒▒▒▓▓▒▓▒▓▓▒▒▒▒▒▒▒▒  ▒▒▒▒▒▒▒▒▓▓▓▓▓▓▓▓▓▓▓▓▓▓▓▓ ▒▒▒▒▒         ▓    ▓    ▓      
▒▒▒▒▒▒▒▓▓▓▓▓▓▓▓▒▒▒▒▒ ▒▒▒▒▒▒▒▒▒▒▒▒▓▓ ▓ ▓  ▓ ▓ ▓▓▒▒▒▒▒▒      ▒▒  ▓    ▓    ▓      
▒▒▒▒▒▒▒▓▓▓▓▓▓▓▓▒▒▒▒   ▒▒▒▒▒▒▒▒▒▒▒▓▓▓▓▓▓▓▓▓▓▓▓▓▓▒▒▒▒▒▒ ▒      ▒▒         ▒ ▒▒▒   
 ▒▒▒▒▒▒▒▒▒▒▒▒▒▒▒▒▒▒▒ ▒▒▒▒ ▒▒▒▒▒▒▒▒▒▒▒▒▒▒▒▒▒▒▒▒▒▒▒▒▒▒   ▒▒▒▒▒    ▒▒▒▒  ▒▒▒▒▒▒▒   
     ▒▒▒▒▒▒▒▒▒▒▒▒▒▒▒▒▒▒  ▒▒▒▒▒▒▒▒▒▒▒▒▒▒▒▒▒▒▒▒▒▒▒▒▒▒▒▒ ▒▒▒     ▒▒▒▒▒▒▒▒▒▒▒▒▒▒    
   ▒▒ ▒▒▒▒▒▒▒▒▒▒▒▒▒▒▒▒▒▒▒▒▒▒▒▒▒▒▒▒▒▒▒▒▒▒▒▒▒▒▒▒▒▒▒▒▒▒▒▒▒    ▒▒▒▒▒▓▒▒▒▒▒▒▒▒▒▒▒▒   
  ▒▒▒▒▒▒▒▒▒▒▒▒▒▒▒▒▒▒▒▒▒▒▒▒▒▒▒▒▒▒▒▒▓▓▒▒▒▒▒▒▒▒▒▒▒▒▒▒▒▒▒       ▒▒▒▓▓▓▒▒▒▒▒▒▓▒▒▒▒ ▒ 
▒▒▒▒▒▓▓▓▓▓▓▓▓▓▓▓▒▒▒▒▒▒ ▒▒▒▒▒▒▒▒▒▒▓▓▓▓▒▒▒▒▒▓▒▒▒▒▒▒▒▒▒    ▒▒▒ ▒▒▓▓▓▓▓▒▒▒▒▓▓▓▒▒▒▒▒ 
▒▒▒▒▒▒▓ ▓ ▓ ▓ ▓▒▒▒▒▒▒   ▒▒▒▒▒▒▒▒▓▓▓▓▓▓▒▒▒▓▓▓▒▒▒▒▒▒▒     ▒▒▒▒▒▒▒▒▓▒▒▒▒▒▓▓▓▓▓▒▒▒▒▒
▒▒▒▒▒▓▓▓▓▓▓▓▓▓▓▓▒▒▒▒▒▒ ▒▒▒▒▒▒▒▒▒▒▓  ▓▒▒▒▓▓▓▓▓▒▒▒▒▒    ▒  ▒▒▒▒▒▒▒▒▒▒▒▒▒▒▒▓▒▒▒▒▒▒▒
▒▒▒▒▒▒▒▒▒▒▒▒▒▒▒▒▒▒▒▒▒▒▒▒▒▒▒   ▒▒▒▒▒▒▒▒▒▒▒▒▓▒▒▒▒▒▒▒   ▒▒▒▒▒▒▒▒▒▒▒▒▒▒ ▒▒▒▒▒▒▒ ▒▒▒▒
  ▒▒▒▒▒▒▒▒▒▒▒▒▒▒▒▒▒▒▒▒▒▒▒▒ ▒   ▒▒▒▒▒▒▒▒▒▒▒▒▒▒▒▒▒▒▒▒▒▒▒▒▒▒▒▒ ▒▒▒▒▒▒▒▒ ▒▒▒▒▒   ▒▒ 
    ▒▒▒▒▒▒▒▒▒▒▒▒▒▒▒▒▒▒▒▒▒▒▒▒▒ ▒▒▒▒ ▒▒▒▒▒▒▒▒▒▒▒▒▒▒▒▒▒▒▒▒▒▒▒▒▒ ▒▒▒▒▒▒▒▒▒▒▒▒▒▒ ▒▒▒ 
▒  ▒▒▒▒▒▒▒▒▒▒▒▒▒▒▒▒▒▒▒▒▒  ▒▒▒▒▒▒▒▒▒  ▒ ▒▒▒▒▒▒▒▒▒▒▒     ▒▒▒▒▒▒▒▒▒▒▒▒▒▒▒▒▒▒▒▒▒▒▒  
▒▒▒▒▒▒▒▒▒▒▒▒▒▒▒▒▒▒▒▒▒▒▒ ▒  ▒▒▒▒▒▒▒▒▒▒▒▒▒▒▒▒▒▒▒▒▒▒   ▒▒  ▒▒▒▒▒▒▓▒▒▒▒▒▒▒▓▒▒▒▒▒  ▒▒
▒▒▒▒▒▒▓▒▓▒▓▒▓▒▓▒▒▒▒▒▒▒▒▒▒▒ ▒▒▒▒▒▒▒▒▒▒▒▒▒▒▒▒▒▒▒▒▒   ▒▒▒▒▒ ▒▒▒▒▓▓▓▒▒▒▒▒▓▓▓▒▒▒▒▒▒▒▒
▒ ▒▒▒▒▓▒▓▒▓▒▓▒▓▒▒▒▒▒ ▒▒▒▒  ▒▒▒▒▒▒▒▒▓▓▓▓▓▒▓▓▓▓▓▒▒▒  ▒▒▒▒▒▒▒▒▒▓▓▓▓▓▒▒▒▓▓▓▓▓▒▒▒▒▒▒▒
▒▒  ▒▒▒▒▒▒ ▒▒▒▒▒▒ ▒   ▒    ▒▒▒▒▒▒▒▓▓ ▓ ▓▓▓ ▓ ▓▓▒▒  ▒▒▒▒▒▒▒▒▒▓▓▓▓▓▓▓▓▓▓▓▓▓▒▒▒▒▒▒▒
     ▒▒▒▒▒  ▒▒▒  ▒▒▒        ▒▒▒▒▒▒▓▓▓▓▓▓▓▓▓▓▓▓▓▒▒▒  ▒▒▒▒▒▒▒▒▒▒▒▒▒▒▒▒▒▒▒▒▒▒▒▒▒▒▒▒
       ▒▒          ▒▒▒▒▒     ▒▒▒▒▒▒▒▒▒▒▒▒▒▒▒▒▒▒▒   ▒▒▒▒▒▒▒▒▒▒▒▒▒▒▒▒▒▒▒▒▒▒▒▒▒▒▒  
      ▒                          ▒▒▒▒▒▒▒▒▒▒        ▒ ▒▒▒▒▒▒▒▒▒▒▒▒▒▒▒▒▒▒▒▒▒▒▒    