!!!!!!!!!!!!!!!!!!!!!!!!!!!!!!!!!!!!!!!!!!!!!!!!!!!!!!!!!!!!!!!!!!!!!!!!!!!!!!!!
!                                                                              !
!                                                                     #######  !
!              ,,,, ,,                                                #     #  !
!          ,,,,           ,,,,, ,,,            ,,                     #     #  !
!         ,      ,,,,,,,,,,,, ,,,  ,         ,,        ,              #  ≣  #  !
!         ,   ,,,  ,,,,,,,    ,,, ,,      ,,  ,,                      #     #  !
!          ,,, , , ,,,,,,,, ,,,,,,       ,  ,,,,               R      #     #  !
!                                        ,, ,,,                       #     #  !
!                                         ,,,,        ,,,             ##▒▒▒##  !
!   #######  #######  #######  #######              ,,,,,,              ,      !
!   #○    #  #    ○#  #  ○  #  #     #             , ,   ,              ,,,    !
!   #     #  #     #  #     #  #     #             , ,, ,               ,,     !
!   #     #  #     #  #     #  #     #              ,,                  ,,     !
!   ## # ##  ## # ##  #     #  #  C  #                                 ,,,,    !
!   ##   ##  ##   ##  #     #  #     #         ,,                     ,,,,     !
!   #     #  #     #  #     #  #     #       ,,,,,,,                    ,,     !
!   ##   ##  ##   ##  ##   ##  ##   ##     , ,, ,,,                    ,,,     !
!                                            ,,,,,,      H             ,,      !
!                                                                      ,,,     !
!      ■        ■        ■                                              ,,     !
!                                                                       ,,     !
!                                                      @                ,,     !
!!!!!!!!!!!!!!!!!!!!!!!!!!!!!!!!!!!!!!!!!!!!!!!!!!!!!!!!!!!!!!!!!!!!!!!!!!!!!!!!